21
12
..#####..........####
..#...############..#
..#..$#.$.$.$.$..$..#
..##.$..#.#.#.#$....#
...#..#.......*.....#
.###.$####@##.#.##.##
##.##.#.##.####$.###.
#.....*.......#..#...
#....$#.#.#.#..$.##..
#..$..$.$.$.$.#$..#..
#..############...#..
####..........#####..