12
17
.......#####.....
.......#...#.....
......##.#.#.....
......#.*..#.....
......#.#.##.....
#######.#..#.....
#...#..$.$.####..
#.#...$$.$$...###
#..*##..@..##*..#
###...$$.$$...#.#
..####.$.$..#...#
.....#..#.#######
.....##.#.#......
.....#..*.#......
.....#.#.##......
.....#...#.......
.....#####.......