8
10
...#####.
...#...#.
####.#.#.
#....#.#.
#......#.
#..##.$##
##..#$$.#
.##...$@#
..##..###
...####..