5
8
#####...
#..@####
#..$...#
###$.#.#
#..$.#.#
#.#$...#
#....###
######..