7
10
#######
#..@..#
#.$.$.#
##.$.##
##.$.##
#.$.$.#
#..$..#
#..$..#
#..#..#
#######