14
18
....##########....
.#####...@.*#####.
.##..$$.##.....##.
.#.#....##....#.#.
##..#.##..##.#..##
##......##.....$##
#*..#.#*##*#.#.$.#
#...#.*....*.#...#
#.##.##.*..##.##.#
#.##.##..*.##.##.#
#...#.*....*.#...#
#.$.#.#*##*#.#..*#
##$.....##......##
##..#.##..##.#..##
.#.#....##....#.#.
.##.....##.$$..##.
.#####*.....#####.
....##########....