14
12
##############...
#......#..#..####
#.####.#..@.....#
#.$.......#..#$.#
##$#####..#.##..#
.#......###...$.#
.#.##.$..##.##..#
##.###.$....#####
#.$..#..#####....
#....####........
###..#...........
..####...........