12
23
...........#...........
..........#.#..........
........##...##........
........#..$..#........
.......#..$.$..#.......
.....##..$.$.$..##.....
.....#..$.$.$.$..#.....
....#..$.$.$.$.$..#....
..##..$.$.$.$.$.$..##..
..#..$.$.$...$.$.$..#..
.#..$.$.$.....$.$.$..#.
#..$.$.$...@...$.$.$..#
.#..$.$.$.....$.$.$..#.
..#..$.$.$...$.$.$..#..
..##..$.$.$.$.$.$..##..
....#..$.$.$.$.$..#....
.....#..$.$.$.$..#.....
.....##..$.$.$..##.....
.......#..$.$..#.......
........#..$..#........
........##...##........
..........#.#..........
...........#...........