10
9
..########..
..#.#...##..
#####.#.####
#.$.$$.$.$.#
#..........#
#.$.$.$$.$.#
####.#.#####
..##.@.#.#..
..########..