13
13
#############
#.....#.....#
#.#.#...#.#.#
#...$.$.$...#
#.#$.$.$.$#.#
#...$.$.$...#
#.#$.$@$.$#.#
#...$.$.$...#
#.#$.$.$.$#.#
#...$.$.$...#
#.#.#.#.#.#.#
#.....#.....#
#############