12
13
.###########.
##....#....##
#..$$...$$..#
#.$..$.$..$.#
#..$$...$$..#
#.$..$.$..$.#
##.$$.*.$$.##
#.$..$.$..$.#
#..$$...$$..#
#.$..$.$..$.#
#..$$.@.$$..#
##....#....##
.###########.