6
12
..####.......
..#..#.......
..#$.#.......
..#..#.####..
###.####..#..
#.........###
#.$*..*.$@..#
##.#$.$#$.#.#
.#.#...#..#.#
.#..######..#
.##........##
..##########.