9
21
.....####............
.....#..########.....
.....#.........#.....
.....#..###.$$.#.....
.....#.$#..#..$#.....
.#####..#....#.######
.#..$...#..#......$.#
.#.$.#.###$###..$...#
.#.$...#.....#####.##
.#..#.##.*$$.#...#.#.
.#.#...$.$@$.$...#.#.
.#.#...#.$$*.##.#..#.
##.#####.....#...$.#.
#...$..###$###.#.$.#.
#.$......#..#...$..#.
######.#....#..#####.
.....#$..#..#$.#.....
.....#.$$.###..#.....
.....#.........#.....
.....########..#.....
............####.....