14
23
.........#####.........
........##...##........
.......##.$.$.##.......
.......##$.$.$##.......
.......#..$.$..#.......
.......#.$.$.$.#.......
.......#..$.$..#.......
..######.$.$.$.######..
.###......$.$......###.
##.$.$.$.$.$.$.$.$.$.##
#.$.$.$.$.$.$.$.$.$.$.#
#..$.$.$.$.@.$.$.$.$..#
#.$.$.$.$.$.$.$.$.$.$.#
##.$.$.$.$.$.$.$.$.$.##
.###......$.$......###.
..######.$.$.$.######..
.......#..$.$..#.......
.......#.$.$.$.#.......
.......#..$.$..#.......
.......##$.$.$##.......
.......##.$.$.##.......
........##...##........
.........#####.........