14
16
..############..
.#......@.....#.
#.#..$.##.$..#.#
#..#.##..##.#..#
#......##......#
#.$#.#*##*#.#$.#
#..#.*....*.#..#
#.#.##.*..##.#.#
#.#.##..*.##.#.#
#..#.*....*.#..#
#.$#.#*##*#.#$.#
#......##......#
#..#.##..##.#..#
#.#..$.##.$..#.#
.#............#.
..############..