26
27
.#########################.
##...#.......#.......#...##
#.#...$.$.$.$.$.$.$.$...#.#
#....$.$.$.$.$.$.$.$.$....#
#...$.$.$.$.$.$.$.$.$.$...#
##.$.$.$.$.$.$.$.$.$.$.$.##
#.$.$.$.$.$.$.$.$.$.$.$.$.#
#..$.$.$.$.$.$.$.$.$.$.$..#
#.$.$.$.$.$.$.$.$.$.$.$.$.#
#..$.$.$.$.$.$.$.$.$.$.$..#
#.$.$.$.$.$.$.$.$.$.$.$.$.#
#..$.$.$.$.......$.$.$.$..#
#.$.$.$.$.$..$..$.$.$.$.$.#
##.$.$.$.$..$@$..$.$.$.$.##
#.$.$.$.$.$..$..$.$.$.$.$.#
#..$.$.$.$.......$.$.$.$..#
#.$.$.$.$.$.$.$.$.$.$.$.$.#
#..$.$.$.$.$.$.$.$.$.$.$..#
#.$.$.$.$.$.$.$.$.$.$.$.$.#
#..$.$.$.$.$.$.$.$.$.$.$..#
#.$.$.$.$.$.$.$.$.$.$.$.$.#
##.$.$.$.$.$.$.$.$.$.$.$.##
#...$.$.$.$.$.$.$.$.$.$...#
#....$.$.$.$.$.$.$.$.$....#
#.#...$.$.$.$.$.$.$.$...#.#
##...#.......#.......#...##
.#########################.