11
13
.....######
######....#
#.$....$$.#
#.$..##...#
#.$##..#$.#
#.$.$$.#..#
#......#$.#
##@#.#$.$.#
.#.....#$.#
.#...**#..#
.#..$....##
.####..###.
....####...