14
9
........######...
#######.#....##..
#.....###.##..##.
#.#..$.##$..#..##
#..#..*.@.*..#..#
##..#..$##.$..#.#
.##..##.###.....#
..##....#.#######
...######........