12
13
.####.#.####.
##..#...#..##
#...#####...#
#..$..*..$..#
###.$.$.$.###
..#..$.$..#..
#.#*$.@.$*#.#
..#..$.$..#..
###.$.$.$.###
#..$..*..$..#
#...#####...#
##..#...#..##
.####.#.####.