13
15
........#####..........
.......##...#.#####....
######.#..$.#.#...####.
#....###.#$####.#....##
#...##...#..#.$$.###..#
#..###..##$.@.$.....#.#
#..#....#.$$.#.$.$$.#.#
#..#...##...$#.....##.#
#.......##$..####.....#
#..##.#......#..#######
#.......#...##.........
#..#.....####..........
#..###.#.#.............
####.#...#.............
.....#####.............