23
13
................#######
.......######.###.....#
.....###....#.#..$$##.#
.#####..$.$.###.#$.##.#
.#.$.$...#......#.....#
##.#.#.$.#..###.#..##.#
#.$..$...####.#..##...#
#.$#.*##$.#...##....###
#.*.......#....######..
#...#######............
##.@#..................
.#..#..................
.####..................