10
18
.....#####...........
.....#...#...........
....##.#.#####.......
...##.*..#...#.......
..###.#.##.#.#####...
###...$$#.*..#...#...
#..*#...$.#.##.#.#...
#.#..*....$$#.*..#...
#...#$$.....$.#.#####
#####.#.$.+...$$#...#
...#..*.#$$....*..#.#
...#.#.##.#.$...#*..#
...#...#..*.#$$...###
...#####.#.##.#.###..
.......#...#..*.##...
.......#####.#.##....
...........#...#.....
...........#####.....