10
12
.....#####....
.....#...###..
..####.....##.
###...#.##..##
#..$.$.$.$$@.#
#..#.##.##...#
##.#.#...#####
#..#....*....#
#.$###...#...#
#.$...###..###
#...#.....##..
###########...