12
12
.....#######.....
.....#..@..#.....
.....#.###.##....
####.#.#.#..#####
#..###.#.#......#
#......#.#.*.$$.#
#.*.$$.#.#.*##.##
#.*##.##.#.*...#.
#.....#..#.*##.#.
#..####..#.....#.
####.....#..####.
.........####....