12
13
...........#.
.#.########.#
..#........#.
.#.*$.$.$*.#.
.#..*###*..#.
.#.$#...#$.#.
.#....@....#.
.#.$#...#$.#.
.#..*###*..#.
.#.*$.$.$*.#.
.#........#..
#.########.#.
.#...........