9
10
.########.
##......##
#..####..#
#......#.#
#.*.$$.#.#
#.*##.#..#
#.+...#.##
#.$###..#.
##.....##.
.#######..