22
24
..####################..
..#......#....#......#..
###$.$..$.$..$.$..$.$###
#.$...$$.#.$$...$$.#.$.#
#..###...#...###...#...#
#.$...$$.#.$$...$$.#.$.#
#..$.$..$.$..$.$..$.$..#
#..$.$..$.$..$.$..$.$..#
#.$.#.$$...$$.#.$$...$.#
##..#...###...#...###.##
#.$.#.$$...$$.#.$$...$.#
#..$.$..$.$..$.$..$.$..#
#..$.$..$.$..$.$..$.$..#
#.$...$$.#.$$...$$.#.$.#
##.###...#...###...#..##
#.$...$$.#.$$...$$.#.$.#
#..$.$..$.$..$.$..$.$..#
#..$.$..$.$..$.$..$.$..#
#.$.#.$$...$$.#.$$...$.#
#...#...###...#...###..#
#.$.#.$$...$$.#.$$...$.#
###$.$..$.$..$.$..$.$###
..#......#....#.....@#..
..####################..