11
10
######.####
#....###..#
#.*.....*.#
##.#***#..#
.#..*+*..##
##.#*$*#.##
#..#.#.#..#
#.........#
#..########
####.......