13
14
........#####........
........#...#####....
...######.#.....##...
...#..##.*.####..##..
.###.......$...#..###
.#...#####$#..$.#...#
.#.$..$..#..$$#.#...#
.###.#..*..........##
###....$#..#.$.$.#.#.
#.$.$##.####.####..#.
#.#..##...@..#....##.
#..##..######..####..
##............##.....
.##############......