30
18
.##########################..#
##........................##..
#.*.*.*.*.*.*.*.*.*.*.*.*.###.
#..$.$.$.$.$.$.$.$.$.$.$...###
#.*.$.*.*.$.*.*.$.*.*.$.*#...#
#..$.$.*.$.$.*.$.$.*.$.$.*.*.#
#.*.*.$.$.*.$.$.*.$.$.*.$.$..#
#..$.*.$.*.*.$.*.*.$.*.*.$.*.#
#.*.*.$.$.*.$.$.*.$.$.*.$.$..#
#..$.$.*.$.$.*+$.$.*.$.$.*.*.#
#.*.$.*.*.$.*.*.$.*.*.$.*.$..#
#..$.$.*.$.$.*.$.$.*.$.$.*.*.#
#.*.*.$.$.*.$.$.*.$.$.*.$.$..#
#...#*.$.*.*.$.*.*.$.*.*.$.*.#
###...$.$.$.$.$.$.$.$.$.$.$..#
.###.*.*.*.*.*.*.*.*.*.*.*.*.#
..##........................##
#..##########################.