10
11
..########..
..#......#..
###*####.#..
#....$.$.#..
#.#......###
#.#$.#.....#
#.#..#@#.#.#
#.$$##.#$#.#
#..$...$...#
#..#########
####........