10
11
.#########.
.#...#...#.
##.#.#.#.##
#.*.*$*.*.#
#....#....#
###.$@$.###
#....#....#
#.*.*$*.*.#
##.#.#.#.##
.#...#...#.
.#########.