10
10
..########.
.##......#.
.#.*$#.#.#.
.#...#$#.##
##*.#..#..#
#...#.*...#
#.$#@..#..#
#.....$.###
##..#...#..
.########..