16
11
.....###########..
....##.........##.
....#..#######..#.
....#.#.......#.#.
....#.#.#####.#.#.
...##.#......$#.##
####..##..###..$.#
#....###$......#.#
#.#$....$.$..#.@.#
#...###..#########
#####.####........