10
12
.#########.
##.......##
#..#####..#
#.......#.#
#.*.$$..#.#
#.*##.##..#
#.*...#..##
#.*##.#.##.
#.+...#.#..
#.$###..#..
##.....##..
.#######...