26
19
...#######........########....
...#.....#........#..##..#....
####.###.#....#####$....$##...
#..#.....###..#......##.$.#...
#.....#....#..#.$.$$$##...#...
#.....#....#####$..#..###.#...
###.#####.##...#..$#.$....#...
#...#..#.......#$..#..#####...
#......#...#..##..##.#..#.....
#...#..####...##.#.$.$..#.....
#####.##......##.#...#..#.....
...#.......####..#####.######.
...#...#......#....#.$$$.#..##
...#...#......##.$........$..#
...########.##############.#.#
........#.@..................#
........#.#.##################
........#...#.................
........#####.................