7
7
#######
#.@.#.#
#$*.$.#
#...$.#
#.....#
#..*..#
#######