8
19
...#####...........
..#....##..######..
.#..##..#.##.....#.
.#.#..#.#.#..###..#
.#.#..#.###.#...#.#
.#.#..$..#..$...#.#
.#..#$#*.#.*#$##..#
.##...*.$.$.*....##
..###..$...$..####.
....###..#..###....
.####..$...$..###..
##....*.$@$.*...##.
#..##$#*.#.*#$#..#.
#.#...$..#..$..#.#.
#.#...#.###.#..#.#.
#..###..#.#.#..#.#.
.#.....##.#..##..#.
..######..##....#..
...........#####...