7
10
...####......
...#..#......
...#$.#......
...#..#.####.
####.####..#.
#..........#.
#..$*..*.$@##
#...#$.$#$..#
#####...#...#
....#########