9
12
..#######
..##..###
###..$###
#.$$.$.#.
#......#.
##.$.$###
###$.$..#
..#.....#
..#..$$.#
.###..###
.###@.##.
.######..