9
9
####.####.
#..###..#.
#..#.$$.#.
#.$$.#..#.
#....#..##
###.$.#..#
..#..*.@.#
..##...###
...#####..