17
21
....#####...#####....
....#...#...#...#....
..###...#####...###..
..#..$.$..#..$.$..#..
###.$.$.$.#.$.$.$.###
#..$.$.$.$.$.$.$.$..#
#...$.$.$...$.$.$...#
#..$.$.$.$.$.$.$.$..#
###.$.$.$.#.$.$.$.###
..#..$.$.....$.$..#..
..###...#.@.#...###..
..#..$.$.....$.$..#..
###.$.$.$.#.$.$.$.###
#..$.$.$.$.$.$.$.$..#
#...$.$.$...$.$.$...#
#..$.$.$.$.$.$.$.$..#
###.$.$.$.#.$.$.$.###
..#..$.$..#..$.$..#..
..###...#####...###..
....#...#...#...#....
....#####...#####....