13
17
....#########....
....#.......#....
..###$#$.$#$###..
..#...........#..
###$#$#$.$#$#$###
#...............#
#.#$#$#$#$#$#$#.#
#...............#
###$#$##@##$#$###
#...............#
#.#$#$#$#$#$#$#.#
#...............#
###$#$#$.$#$#$###
..#...........#..
..###$#$.$#$###..
....#.......#....
....#########....