7
9
#######....
#.....####.
#.#.#....##
#.$$$**$$.#
#....@....#
#.$$**$$$.#
##....#.#.#
.####.....#
....#######