10
22
.....#####............
.....#...#####........
.....#.#.#...#####....
.....#.....#.#...#....
..#####$#......#$#....
..#.$..$.####$...#####
..#.#.#.....#.##.#...#
..#...#####.#.#.$$.#.#
.###.$......#@#..#...#
.#...####.....#.#..###
.#.#.#........#.#...#.
.#...#.#........#.#.#.
###..#.#.....####...#.
#...#..#.#......$.###.
#.#.$$.#.#.#####...#..
#...#.##.#.....#.#.#..
#####...$####.$..$.#..
....#$#......#$#####..
....#...#.#.....#.....
....#####...#.#.#.....
........#####...#.....
............#####.....