9
9
....#####
.####...#
.#..$$#.#
##.*..$.#
#@..#...#
#.$..*.##
#.#$$..#.
#...####.
#####....