12
16
........####....
........#..#....
........#..#....
........#..#....
##########.#....
#....$.$.$$#....
#.@..$..*..#....
#...#.*...$#....
#####$...*.#####
....#..*..$#...#
....#$$.$.$....#
....#.##########
....#..#........
....#..#........
....#..#........
....####........