26
17
################...#######.....
#..............#...#.....#.....
#..$.$.$.$.###.#####.###.##....
#.$.$.$.$.$....#....$....##....
#..$.$.###.#.#.#.###.#.#.###...
#.$.$.$....#....$....#.....#...
##.###.#.#.#.###.#.#.#.###.##..
.#.....#....$....#....$.$.$##..
.###.#.#.###.#.@.#.###.#.#.###.
..##$.$.$....#....$....#.....#.
..##.###.#.#.#.###.#.#.#.###.##
...#.....#....$....#....$.$.$.#
...###.#.#.###.#.#.#.###.$.$..#
....##....$....#....$.$.$.$.$.#
....##.###.#####.###.$.$.$.$..#
.....#.....#...#..............#
.....#######...################