14
18
..........####....
..........#..#....
..........#..#....
..........#..#....
############.#....
#....$.$.*.$$#....
#.@..$..*.*..#....
#...#.*..$..$#....
#####*.$...*.#....
....#.*...$.*#....
....#$..$..*.#####
....#..*.*..$#...#
....#$$.*.$.$....#
....#.############
....#..#..........
....#..#..........
....#..#..........
....####..........