15
17
..######.######..
.#.....###.....#.
#..$.$..#..$.$..#
#.$.$.$.#.$.$.$.#
#..$.$.###.$.$..#
#.$.$.#.....$.$.#
#..$..#$.$##.$..#
##..#.$...$.#..##
.####...@...####.
##..#.$...$.#..##
#..$.##$.$#..$..#
#.$.$.....#.$.$.#
#..$.$.###.$.$..#
#.$.$.$.#.$.$.$.#
#..$.$..#..$.$..#
.#.....###.....#.
..######.######..