14
9
++++++++######+++
#######+#++++##++
#+++++###+##++##+
#+#++$.##$++#++##
#++#++*.@.*++#++#
##++#++$##.$++#+#
+##++##+###+++++#
++##++++#+#######
+++######++++++++