12
13
+####+#+####+
##++#+++#++##
#+++#####+++#
#++$.+*+.$++#
###.$.$.$.###
++#+.$+$.+#++
#+#*$+@+$*#+#
++#+.$+$.+#++
###.$.$.$.###
#++$.+*+.$++#
#+++#####+++#
##++#+++#++##
+####+#+####+