26
27
+#########################+
##+++#+++++++#+++++++#+++##
#+#++.$.$.$.$+$.$.$.$.++#+#
#+++.$.$.$.$.$.$.$.$.$.+++#
#++.$.$.$.$.$.$.$.$.$.$.++#
##.$.$.$.$.$.$.$.$.$.$.$.##
#+$.$.$.$.$.$.$.$.$.$.$.$+#
#+.$.$.$.$.$.$.$.$.$.$.$.+#
#+$.$.$.$.$.$.$.$.$.$.$.$+#
#+.$.$.$.$.$.$.$.$.$.$.$.+#
#+$.$.$.$.$.$.$.$.$.$.$.$+#
#+.$.$.$.$.+++++.$.$.$.$.+#
#+$.$.$.$.$++$++$.$.$.$.$+#
##+$.$.$.$.+$@$+.$.$.$.$+##
#+$.$.$.$.$++$++$.$.$.$.$+#
#+.$.$.$.$.+++++.$.$.$.$.+#
#+$.$.$.$.$.$.$.$.$.$.$.$+#
#+.$.$.$.$.$.$.$.$.$.$.$.+#
#+$.$.$.$.$.$.$.$.$.$.$.$+#
#+.$.$.$.$.$.$.$.$.$.$.$.+#
#+$.$.$.$.$.$.$.$.$.$.$.$+#
##.$.$.$.$.$.$.$.$.$.$.$.##
#++.$.$.$.$.$.$.$.$.$.$.++#
#+++.$.$.$.$.$.$.$.$.$.+++#
#+#++.$.$.$.$+$.$.$.$.++#+#
##+++#+++++++#+++++++#+++##
+#########################+