12
12
+++++#######+++++
+++++#++@++#+++++
+++++#+###+##++++
####+#+#+#++#####
#++###+#+#+.++++#
#+.++++#+#+*+$$+#
#+*+$$+#+#+*##+##
#+*##+##+#+*+++#+
#+.+++#++#+*##+#+
#++####++#+.+++#+
####+++++#++####+
+++++++++####++++