14
18
++++##########++++
+#####+++@+*#####+
+##++$$+##.+.++##+
+#+#++++##++++#+#+
##++#+##++##+#++##
##.+++++##+++++$##
#*++#+#*##*#+#+$+#
#+.+#+*++++*+#+++#
#+##+##+*++##+##+#
#+##+##++*+##+##+#
#+++#+*++++*+#+.+#
#+$+#+#*##*#+#++*#
##$+++++##+++++.##
##++#+##++##+#++##
+#+#++++##++++#+#+
+##++.+.##+$$++##+
+#####*+++++#####+
++++##########++++