12
17
+++++++#####+++++
+++++++#+++#+++++
++++++##+#+#+++++
++++++#+*++#+++++
++++++#+#+##+++++
#######+#++#+++++
#+++#+.$.$.####++
#+#+++$$.$$+++###
#++*##..@..##*++#
###+++$$.$$+++#+#
++####.$.$.+#+++#
+++++#++#+#######
+++++##+#+#++++++
+++++#++*+#++++++
+++++#+#+##++++++
+++++#+++#+++++++
+++++#####+++++++