7
10
#######
#++@++#
#+$.$+#
##.$.##
##+$+##
#+$.$+#
#+.$.+#
#+.$.+#
#++#++#
#######