13
17
++++#########++++
++++#+++++++#++++
++###$#$+$#$###++
++#+.+.+.+.+.+#++
###$#$#$+$#$#$###
#+.+.+.+.+.+.+.+#
#+#$#$#$#$#$#$#+#
#+.+.+.+++.+.+.+#
###$#$##@##$#$###
#+.+.+.+++.+.+.+#
#+#$#$#$#$#$#$#+#
#+.+.+.+.+.+.+.+#
###$#$#$+$#$#$###
++#+.+.+.+.+.+#++
++###$#$+$#$###++
++++#+++++++#++++
++++#########++++