15
17
++######+######++
+#+++++###+++++#+
#+.$.$.+#+.$.$.+#
#+$.$.$+#+$.$.$+#
#+.$.$+###+$.$.+#
#+$.$.#++++.$.$+#
#+.$++#$+$##+$.+#
##++#+$...$+#++##
+####++.@.++####+
##++#+$...$+#++##
#+.$+##$+$#++$.+#
#+$.$.++++#.$.$+#
#+.$.$+###+$.$.+#
#+$.$.$+#+$.$.$+#
#+.$.$.+#+.$.$.+#
+#+++++###+++++#+
++######+######++