13
13
#############
#+++++#+++++#
#+#+#+++#+#+#
#++.$.$.$.++#
#+#$.$.$.$#+#
#++.$.$.$.++#
#+#$.$@$.$#+#
#++.$.$.$.++#
#+#$.$.$.$#+#
#++.$.$.$.++#
#+#+#+#+#+#+#
#+++++#+++++#
#############