14
18
++++++++++####++++
++++++++++#++#++++
++++++++++#++#++++
++++++++++#++#++++
############+#++++
#++++$+$.*+$$#++++
#+@++$..*.*.+#++++
#+++#+*++$+.$#++++
#####*.$+++*.#++++
++++#.*+++$.*#++++
++++#$.+$++*+#####
++++#+.*.*..$#+++#
++++#$$+*.$+$++++#
++++#+############
++++#++#++++++++++
++++#++#++++++++++
++++#++#++++++++++
++++####++++++++++