26
17
################+++#######+++++
#++++++++++++++#+++#+++++#+++++
#++$+$+$+$+###+#####+###+##++++
#+$+$+$+$+$++.+#++++$++.+##++++
#++$+$+###+#.#.#+###+#.#.###+++
#+$+$+$++.+#+.++$++.+#+.+++#+++
##+###+#.#.#+###+#.#.#+###+##++
+#+++.+#+.++$++++#+.++$+$.$##++
+###.#.#+###+#+@+#+###+#.#.###+
++##$.$+$++.+#++++$++.+#+.+++#+
++##+###+#.#.#+###+#.#.#+###+##
+++#+++.+#+.++$++.+#+.++$+$+$+#
+++###.#.#+###+#.#.#+###+$+$++#
++++##+.++$++++#+.++$+$+$+$+$+#
++++##+###+#####+###+$+$+$+$++#
+++++#+++++#+++#++++++++++++++#
+++++#######+++################