10
18
+++++#####+++++++++++
+++++#+++#+++++++++++
++++##+#+#####+++++++
+++##+*++#+++#+++++++
++###+#+##+#+#####+++
###+++$$#+*++#+++#+++
#++*#.++$+#+##+#+#+++
#+#++*...+$$#+*++#+++
#+++#$$+....$+#+#####
#####+#+$.+..+$$#+++#
+++#++*+#$$+...*++#+#
+++#+#+##+#+$++.#*++#
+++#+++#++*+#$$+++###
+++#####+#+##+#+###++
+++++++#+++#++*+##+++
+++++++#####+#+##++++
+++++++++++#+++#+++++
+++++++++++#####+++++