12
13
+###########+
##++++#++++##
#+.$$.+.$$.+#
#+$..$+$..$+#
#+.$$...$$.+#
#+$..$+$..$+#
##+$$.*.$$+##
#+$..$+$..$+#
#+.$$...$$.+#
#+$..$+$..$+#
#+.$$.@.$$.+#
##++++#++++##
+###########+