13
14
++++++++#####++++++++
++++++++#+++#####++++
+++######+#+++++##+++
+++#++##+*+####++##++
+###+++++++$+++#++###
+#+++#####$#++$+#+++#
+#+$++$++#++$$#+#+++#
+###.#..*.........+##
###++++$#++#+$+$+#+#+
#+$+$##+####+####++#+
#+#++##+++@++#++++##+
#++##++######++####++
##++++++++++++##+++++
+##############++++++