7
9
#######++++
#+++++####+
#+#+#+.++##
#+$$$**$$+#
#....@....#
#+$$**$$$+#
##++.+#+#+#
+####+++++#
++++#######