10
22
+++++#####++++++++++++
+++++#+++#####++++++++
+++++#+#+#+++#####++++
+++++#+++++#+#+++#++++
++#####$#++++++#$#++++
++#+$++$+####$+++#####
++#+#+#+++++#+##+#+++#
++#+++#####+#+#+$$+#+#
+###+$++++++#@#++#+++#
+#+++####....+#+#++###
+#+#+#+++....+#+#+++#+
+#+++#+#+....+++#+#+#+
###++#+#+....####+++#+
#+++#++#+#++++++$+###+
#+#+$$+#+#+#####+++#++
#+++#+##+#+++++#+#+#++
#####+++$####+$++$+#++
++++#$#++++++#$#####++
++++#+++#+#+++++#+++++
++++#####+++#+#+#+++++
++++++++#####+++#+++++
++++++++++++#####+++++