12
23
+++++++++++#+++++++++++
++++++++++#+#++++++++++
++++++++##+++##++++++++
++++++++#++$++#++++++++
+++++++#++$+$++#+++++++
+++++##+.$.$.$.+##+++++
+++++#+.$.$.$.$.+#+++++
++++#+.$.$.$.$.$.+#++++
++##+.$.$.$.$.$.$.+##++
++#++$.$.$.+.$.$.$++#++
+#++$.$.$.+++.$.$.$++#+
#++$+$.$.++@++.$.$+$++#
+#++$.$.$.+++.$.$.$++#+
++#++$.$.$.+.$.$.$++#++
++##+.$.$.$.$.$.$.+##++
++++#+.$.$.$.$.$.+#++++
+++++#+.$.$.$.$.+#+++++
+++++##+.$.$.$.+##+++++
+++++++#++$+$++#+++++++
++++++++#++$++#++++++++
++++++++##+++##++++++++
++++++++++#+#++++++++++
+++++++++++#+++++++++++