17
21
++++#####+++#####++++
++++#+++#+++#+++#++++
++###+++#####+++###++
++#+.$.$.+#++$.$++#++
###+$.$.$+#.$.$.$.###
#++$.$.$.$+$.$.$.$++#
#++.$.$.$.+.$.$.$.++#
#++$.$.$.$+$.$.$.$++#
###+$.$.$+#.$.$.$.###
++#+.$.$.+.++$.$++#++
++###+++#.@.#+++###++
++#++$.$++.+.$.$.+#++
###.$.$.$.#+$.$.$+###
#++$.$.$.$+$.$.$.$++#
#++.$.$.$.+.$.$.$.++#
#++$.$.$.$+$.$.$.$++#
###.$.$.$.#+$.$.$+###
++#++$.$++#+.$.$.+#++
++###+++#####+++###++
++++#+++#+++#+++#++++
++++#####+++#####++++