7
7
#######
#.@+#+#
#$*+$+#
#+++$+#
#+..++#
#++*++#
#######