12
13
+++++++++++#+
+#+########+#
++#++++++++#+
+#+*$.$.$*+#+
+#++*###*++#+
+#+$#+++#$+#+
+#..+.@.+..#+
+#+$#+++#$+#+
+#++*###*++#+
+#+*$.$.$*+#+
+#++++++++#++
#+########+#+
+#+++++++++++