8
19
+++#####+++++++++++
++#++++##++######++
+#++##++#+##+++++#+
+#+#++#+#+#++###++#
+#+#++#+###+#+++#+#
+#+#++$++#++$+++#+#
+#++#$#*.#.*#$##++#
+##+++*.$+$.*++++##
++###+.$+.+$.+####+
++++###+.#.+###++++
+####+.$+.+$.+###++
##++++*.$@$.*+++##+
#++##$#*.#.*#$#++#+
#+#+++$++#++$++#+#+
#+#+++#+###+#++#+#+
#++###++#+#+#++#+#+
+#+++++##+#++##++#+
++######++##++++#++
+++++++++++#####+++