23
13
++++++++++++++++#######
+++++++######+###+++++#
+++++###++++#+#++$$##.#
+#####++$+$+###+#$+##.#
+#+$+$+++#++++++#++++.#
##+#+#+$+#++###+#++##+#
#+$++$+++####+#++##+++#
#+$#.*##$+#+++##++++###
#.*.....+.#++++######++
#++.#######++++++++++++
##+@#++++++++++++++++++
+#++#++++++++++++++++++
+####++++++++++++++++++