14
12
##############+++
#++++++#++#++####
#+####+#++@+++.+#
#+$.....++#++#$+#
##$#####++#+##.+#
+#++++++###+++$+#
+#+##+$++##+##++#
##+###+$++++#####
#+$++#++#####++++
#++++####++++++++
###++#+++++++++++
++####+++++++++++