12
16
++++++++####++++
++++++++#++#++++
++++++++#++#++++
++++++++#++#++++
##########+#++++
#++++$+$+$$#++++
#+@++$..*.+#++++
#+++#+*...$#++++
#####$...*+#####
++++#+.*..$#+++#
++++#$$+$+$++++#
++++#+##########
++++#++#++++++++
++++#++#++++++++
++++#++#++++++++
++++####++++++++