6
12
++####+++++++
++#++#+++++++
++#$+#+++++++
++#++#+####++
###+####++#++
#++..+..++###
#+$*.+*.$@++#
##+#$+$#$+#+#
+#+#+++#++#+#
+#++######++#
+##++++++++##
++##########+