10
11
+#########+
+#+++#+++#+
##+#+#+#+##
#+*.*$*.*+#
#++++#++++#
###+$@$+###
#++++#++++#
#+*.*$*.*+#
##+#+#+#+##
+#+++#+++#+
+#########+