14
16
++############++
+#++++++@+++++#+
#+#++$+##+$++#+#
#++#.##++##.#++#
#++.+++##+++.++#
#+$#+#*##*#+#$+#
#++#+*++++*+#++#
#+#+##+*++##+#+#
#+#+##++*+##+#+#
#++#+*++++*+#++#
#+$#+#*##*#+#$+#
#++.+++##+++.++#
#++#.##++##.#++#
#+#++$+##+$++#+#
+#++++++++++++#+
++############++