8
10
+++#####+
+++#+++#+
####+#+#+
#+.+.#+#+
#++.+++#+
#+.##+$##
##++#$$+#
+##+++$@#
++##++###
+++####++