13
15
++++++++#####++++++++++
+++++++##+++#+#####++++
######+#++$+#+#+++####+
#++++###+#$####+#++++##
#+++##+++#++#+$$+###++#
#++###++##$+@+$+++++#+#
#++#++.+#+$$+#+$+$$+#+#
#..#++.##+++$#+++++##+#
#+++++.+##$++####+++++#
#..##.#++++++#++#######
#+++++.+#+++##+++++++++
#..#++.++####++++++++++
#++###.#+#+++++++++++++
####+#+++#+++++++++++++
+++++#####+++++++++++++