16
11
+++++###########++
++++##+++++++++##+
++++#++#######++#+
++++#+#+++++++#+#+
++++#+#+#####+#+#+
+++##+#++++++$#+##
####++##++###+.$+#
#++++###$+.....#+#
#+#$++++$+$++#+@+#
#+++###++#########
#####+####++++++++