11
10
######+####
#++++###++#
#+*+++++*+#
##+#***#++#
+#++*+*++##
##+#*$*#+##
#++#+#+#++#
#+++++++++#
#++########
####+++++++