26
19
+++#######++++++++########++++
+++#+++++#++++++++#++##++#++++
####+###+#++++#####$++++$##+++
#++#+++++###++#++++++##+$+#+++
#+++++#++++#++#+$+$$$##+++#+++
#+++++#++++#####$++#++###+#+++
###+#####+##+++#++$#+$++++#+++
#+++#++#+++++++#$++#++#####+++
#++++++#+++#++##++##+#++#+++++
#+++#++####+++##+#+$+$++#+++++
#####+##++++++##+#+++#++#+++++
+++#+++++++####++#####+######+
+++#+++#++++++#++++#+$$$+#++##
+++#+++#++++++##+$++++++++$++#
+++########+##############+#+#
++++++++#+@..................#
++++++++#+#+##################
++++++++#+++#+++++++++++++++++
++++++++#####+++++++++++++++++