22
24
++####################++
++#++++++#++++#++++++#++
###$.$++$.$++$.$++$.$###
#+$.+.$$.#.$$.+.$$.#.$+#
#+.###..+#+..###..+#+.+#
#+$.+.$$.#.$$.+.$$.#.$+#
#++$.$++$.$++$.$++$.$++#
#++$.$++$.$++$.$++$.$++#
#+$.#.$$.+.$$.#.$$.+.$+#
##.+#+..###..+#+..###.##
#+$.#.$$.+.$$.#.$$.+.$+#
#++$.$++$.$++$.$++$.$++#
#++$.$++$.$++$.$++$.$++#
#+$.+.$$.#.$$.+.$$.#.$+#
##.###..+#+..###..+#+.##
#+$.+.$$.#.$$.+.$$.#.$+#
#++$.$++$.$++$.$++$.$++#
#++$.$++$.$++$.$++$.$++#
#+$.#.$$.+.$$.#.$$.+.$+#
#+.+#+..###..+#+..###.+#
#+$.#.$$.+.$$.#.$$.+.$+#
###$.$++$.$++$.$++$.$###
++#++++++#++++#+++++@#++
++####################++