7
10
+++####++++++
+++#++#++++++
+++#$+#++++++
+++#++#+####+
####+####++#+
#+++..+..++#+
#++$*.+*.$@##
#+++#$+$#$++#
#####+++#+++#
++++#########