10
10
++########+
+##++.+.+#+
+#+*$#+#+#+
+#.++#$#+##
##*+#++#++#
#+++#+*+++#
#+$#@+.#++#
#+++++$+###
##++#+++#++
+########++