9
12
++#######
++##++###
###+.$###
#+$$.$+#+
#+.+.++#+
##+$.$###
###$.$++#
++#+.+.+#
++#+.$$+#
+###.+###
+###@+##+
+######++