9
10
+########+
##++++++##
#+.####++#
#+.++++#+#
#+*+$$+#+#
#+*##+#++#
#+++++#+##
#+$###++#+
##+++++##+
+#######++