10
11
++########++
++#++++++#++
###*####.#++
#++++$+$+#++
#+#......###
#+#$+#+++++#
#+#.+#@#+#+#
#+$$##+#$#+#
#++$+++$+++#
#++#########
####++++++++