9
9
++++#####
+####+++#
+#++$$#+#
##+*..$+#
#@+.#.++#
#+$..*+##
#+#$$++#+
#+++####+
#####++++