10
12
+++++#####++++
+++++#+++###++
++####+++++##+
###+++#.##++##
#++$+$+$+$$@+#
#++#+##.##+++#
##+#+#+.+#####
#++#+...*.+++#
#+$###+++#+++#
#+$+++###++###
#+++#+++++##++
###########+++