21
12
++#####++++++++++####
++#+++############..#
++#++$#+$+$+$+$++$++#
++##+$++#+#+#+#$++..#
+++#++#+.+.+.+*..+++#
+###+$####@##+#+##+##
##+##+#+##+####$+###+
#+++..*+.+.+.+#++#+++
#..++$#+#+#+#++$+##++
#++$++$+$+$+$+#$++#++
#..############+++#++
####++++++++++#####++