5
8
#####+++
#++@####
#++$.++#
###$.#+#
#++$.#+#
#+#$.++#
#++++###
######++