30
18
+##########################++#
##++++++++++++++++++++++++##++
#+*.*.*+*.*.*+*.*.*+*.*.*+###+
#+.$+$.$.$+$.$.$+$.$.$+$.+.###
#+*+$+*+*+$+*+*+$+*+*+$+*#+++#
#+.$+$.*.$+$.*.$+$.*.$+$.*.*+#
#+*.*.$+$.*.$+$.*.$+$.*.$+$.+#
#++$+*+$+*+*+$+*+*+$+*+*+$+*+#
#+*.*.$+$.*.$+$.*.$+$.*.$+$.+#
#+.$+$.*.$+$.*+$+$.*.$+$.*.*+#
#+*+$+*+*+$+*+*+$+*+*+$+*+$++#
#+.$+$.*.$+$.*.$+$.*.$+$.*.*+#
#+*.*.$+$.*.$+$.*.$+$.*.$+$.+#
#+++#*+$+*+*+$+*+*+$+*+*+$+*+#
###.+.$+$.$.$+$.$.$+$.$.$+$.+#
+###+*.*.*+*.*.*+*.*.*+*.*.*+#
++##++++++++++++++++++++++++##
#++##########################+