10
9
++########++
++#+#+++##++
#####+#+####
#+$+$$+$+$+#
#..........#
#+$+$+$$+$+#
####+#+#####
++##+@+#+#++
++########++