11
13
+++++######
######++++#
#+$++++$$+#
#+$++##+++#
#+$##++#$+#
#+$+$$+#++#
#+.....#$+#
##@#.#$+$+#
+#.....#$+#
+#...**#++#
+#++$++++##
+####++###+
++++####+++