10
12
+#########+
##+++++++##
#+.#####++#
#+.+++++#+#
#+*+$$++#+#
#+*##+##++#
#+*+++#++##
#+*##+#+##+
#+++++#+#++
#+$###++#++
##+++++##++
+#######+++