14
23
+++++++++#####+++++++++
++++++++##+++##++++++++
+++++++##.$.$.##+++++++
+++++++##$.$.$##+++++++
+++++++#+.$.$.+#+++++++
+++++++#+$.$.$+#+++++++
+++++++#+.$.$.+#+++++++
++######+$.$.$+######++
+###+++++.$.$.+++++###+
##.$.$.$.$.$.$.$.$.$.##
#+$.$.$.$.$+$.$.$.$.$+#
#+.$.$.$.$+@+$.$.$.$.+#
#+$.$.$.$.$+$.$.$.$.$+#
##.$.$.$.$.$.$.$.$.$.##
+###+++++.$.$.+++++###+
++######+$.$.$+######++
+++++++#+.$.$.+#+++++++
+++++++#+$.$.$+#+++++++
+++++++#+.$.$.+#+++++++
+++++++##$.$.$##+++++++
+++++++##.$.$.##+++++++
++++++++##+++##++++++++
+++++++++#####+++++++++