9
21
+++++####++++++++++++
+++++#++########+++++
+++++#++.++++++#+++++
+++++#++###+$$+#+++++
+++++#+$#++#+.$#+++++
+#####++#+.+.#.######
+#++$.++#++#+.++++$+#
+#+$.#.###$###++$+++#
+#+$+.+#.+++.#####.##
+#++#+##+*$$+#+++#+#+
+#+#+.+$+$@$+$+.+#+#+
+#+#+++#+$$*+##+#++#+
##.#####.+++.#+.+$+#+
#+++$++###$###.#.$+#+
#+$++++.+#++#++.$++#+
######.#.+.+#++#####+
+++++#$.+#++#$+#+++++
+++++#+$$+###++#+++++
+++++#++++++.++#+++++
+++++########++#+++++
++++++++++++####+++++