9
9
####+####+
#++###++#+
#++#+$$+#+
#+$$+#++#+
#++++#++##
###+$.#++#
++#..*.@.#
++##+++###
+++#####++